NO wolf_tex/purplestone.xpm
SO wolf_tex/greystone.xpm
EA wolf_tex/redbrick.xpm
WE wolf_tex/wood.xpm

F 0, 102, 0
C 0, 128, 255
	
       11111111111111
       10000000000001
11111111000011111100111111111111111111
1000000000001    100000000000000000001
10011111111111111111111111101111111101
1000000000000000001       101      101
1001111111111111101       101      1011111111111111
1000000000001   101       101      1000000000000001
1000000000001  11011      101      1011111111111101
1001111111001  10001      101      101          101
1001     10011110001111111101111111101          101
1001     10000000000000000000000000001          101
100111111111111100011111111111111111111111111111101
100000000000000000000000000000000000000000000000001
111111111111111100011111111111111111111111111111111
               10001
            11110001111
            10000000001
            10000000001
            10000000001
            10000000001
            10000000001
            10000000001
            10000000001
            10000000001
            10000N00001
            11111111111