NO wolf_tex/error2.xpm
SO wolf_tex/greystone.xpm
EA wolf_tex/redbrick.xpm
WE wolf_tex/wood.xpm

F 0, 102, 0
C 0, 128, 255

       11111111111111
       100S0000000001
111111110000111111001
1000000000001    1001
1001111111111    1111
1001
1001111111111        
1000000000001
1000000000001  11111
1001111111001  10001
1001     10011110001
1001     10000000001
1111     11111111111
