NO textures/north_path.txt
SO textures/south_path.txt
EA textures/east_path.txt
WE textures/west_path.txt

F 10, 10, 10
C 100, 100, 100
	
11111
10001
11111